FIFA Football 2004 là một trò chơi bóng đá do hãng EA Sports phát hành vào tháng 10 năm 2003. FIFA Football 2004 là phiên bản thứ 11 của FIFA Series. Các cầu thủ được chọn quảng cáo Alessandro Del Piero, Thierry Henry và Ronaldinho. Đoạn phim đầu game diễn ra tại sân St James' Park của CLB Newcastle United cùng với bài hát Red Morning Light do Kings of Leon trình bày. Với việc có thêm 7 giải đấu trong FIFA Football 2004 nên số CLB tại phần Rest of World đã giảm xuống còn có 16 đội. Trong đó có 6 đội đầu tiên có mặt thuộc Nam Mỹ mà không đến từ Brasil, đó là Club America, Toluca, C.F. Monterrey, U.N.A.M từ (México) và Boca Juniors, River Plate (từ Argentina).


== Các giải đấu trong FIFA Football 2004 ==


== Các đội tuyển quốc gia trong FIFA Football 2004 ==


== Danh sách các bài hát ==
The Dandy Warhols: "We Used to Be Friends"
Asian Dub Foundation: "Rise To The Challenge"
Babamania: "Wanna Rock"
Café Tacuba: "Eo" (El Sonidero)
The Cooper Temple Clause: "Promises, Promises"
DJ Sensei: "Musica Grande"
Kasabian: "L.S.F"
Kings Of Leon: "Red Morning Light"
Caesars: "Jerk It Out"
Goldfrapp: "Train"
Paul van Dyk: "Nothing But You"
The Jam: "Town Called Malice"
Kane: "Rain Down on Me" (Tiesto Remix)
Radiohead: "Myxomatosis"
Junior Senior: "Rhythm Bandits"
The Stone Roses: "Fools Gold"
Tosca: "Gute Laune"
Lostprophets: "Burn Burn"
The Raveonettes: "That Great Love Sound"
Suburbia: "Always"
The Clones: "Crazy Boys"
The Individuals: "Take A Ride"
Timo Maas: "Unite"
Tribalistas: "Já Sei Namorar"
Underworld: "Two Months Off"
Vicentico: "Se Despierta La Ciudad"
Wir sind Helden: "Guten Tag "
Zeca Pagodinho: "Deixa A Vida Me Levar"


== Các sân vận động trong FIFA Football 2004: ==


== Tham khảo ==


== Liên kết ngoài ==
Trang chủ của hãng EA
Danh sách các bản FIFA trên GameSpot
FIFA Series tại DMOZ