Nguyên thủ quốc gia là người đứng đầu một quốc gia.
Trong một số quốc gia, nguyên thủ kiêm trách nhiệm đứng đầu cơ quan hành pháp. Tuy nhiên, hiện nay ngoài một vài nguyên thủ quốc gia như Tổng thống Hoa Kỳ, Tổng thống Hàn Quốc, Tổng thống Indonesia, Chủ tịch Cuba,… cũng là người đứng đầu chính phủ, hầu hết các nguyên thủ quốc gia khác chỉ giữ một chức vụ danh dự với những quyền lực hạn chế như đại diện quốc gia trong các nghi lễ quan trọng, phong thưởng các tước hàm cao cấp, ký các sắc lệnh và tuyên bố tình trạng chiến tranh.


== Một số danh xưng Việt dùng để chỉ vị trí Nguyên thủ quốc gia ==
Ngoài ra còn một số danh xưng nguyên thủ được xem là tương đương với danh hiệu Hoàng đế, như:
Sultan = Vua Thổ Nhĩ Kỳ, vua ở một số nước Hồi giáo;
Êmia = Tiểu vương (Hồi giáo);
Shah = Vua Ba Tư;
Padishah = Vua Ba Tư, vua Thổ Nhĩ Kỳ;
Kaiser = Danh hiệu của các Hoàng đế La Mã Thần thánh, cũng như các Hoàng đế Áo và Hoàng đế Đức sau này;
Và 2 danh hiệu danh cho 2 nhà độc tài ở châu Âu:
Führer = (chỉ dùng cho Hitler);
Duce (chỉ dùng cho Mussolini);


== Các vị nguyên thủ trên thế giới ==
Để tra cứu nhanh các vị nguyên thủ đương nhiệm, xin xem Danh sách lãnh tụ quốc gia.
Để tra cứu về các vị cựu nguyên thủ, xin xem danh sách theo từng nước, thí dụ:
Anh: Nữ hoàng Anh
Campuchia: Danh sách nguyên thủ quốc gia Campuchia
Canada: Toàn quyền Canada
Đức: Tổng thống Đức
Hoa Kỳ: Tổng thống Hoa Kỳ
Lào: Chủ tịch nước Lào
Liên Xô: Danh sách lãnh tụ Liên Xô
Nga: Tổng thống Nga
Pháp: Tổng thống Pháp
Cộng hòa Nhân dân Trung Hoa: Chủ tịch nước Cộng hòa Nhân dân Trung Hoa
Úc: Toàn quyền Úc
Việt Nam: Vua Việt Nam

Tổng thống Việt Nam Cộng Hòa
Chủ tịch nước Việt Nam


== Chú thích ==